111111111111111111111111111111111111111111
100010001000101010100000010001000100010001
1E00100010C010100010001001000100010000C001
10001C00100C0010101110100110110C0100010001
11101110001010001010C010000001101111011011
100010001C000C1010100010010000000100010001
100000001C00001010111111111011110001110111
1111101111111111111000100100010001000100C1
10010C001000100000100010000001P00100000001
1000010010001001001C0010010001101110110111
110100001011100100111011011011000100010001
10010100100011011110001C110001011111111101
100001000000100010000011111111000100010001
110111001011100000110110001001000100010001
1000010010001000101000000C0001101101000001
111011111111111110101111111111C00100011101
10000000C010100000100010001001011100010001
100000100000100010100010001001000111110111
1011001000101110111000101110C101110C000101
1001101101111C0000111000001100000100010001
1001001000000000101000100C0001000100010101
111111111111111111111111111111111111111111
