111111111111111111111111111111111111111111
100100010000001000100000100100001000100101
100100010C01001000100010100100101000100101
1000000100C1000010000010100000101011100001
111111011011001000110111101101100000101111
10001001000110100010001C1001C0001010000101
100000010001001000100000101111111000100101
101111011111111101111111100000001000100001
100010010010100100000100100001C01111110111
100010010000100100100100111011011C01000001
111011111110110110101101100001001000010001
100011E10010100000100000000101011110111111
100011P1000C000111111111100101001000000001
100000010010100010010100111111011001001001
111011110111100000000000100000001101011101
100000010000100010010100111011111001001001
1111011100101111111101101000000C0C01001001
100001000010100000100100111111110111111111
100000011011100100100101100010010010100001
111011010010101101110100100000000000100101
10000101C000100100000100100010010010000101
111111111111111111111111111111111111111111